0 0 0 0 0 0 0 0 0 0 0 0 0 0  0  0 0 0 0 0 0 0 0 0 0 0 0 0 0 0
0 0 0 0 0 0 0 0 0 0 7 7 7 7  7  7 7 7 7 7 0 0 0 0 0 0 0 0 0 0
0 0 0 0 0 0 0 0 0 0 7 7 7 7  7  7 7 7 7 7 0 0 0 0 0 0 0 0 0 0
0 0 0 0 0 0 0 0 7 7 7 7 6 6  6  6 6 6 7 7 7 7 0 0 0 0 0 0 0 0
0 0 0 0 0 0 0 0 7 7 6 6 6 6  6  6 6 6 6 6 7 7 0 0 0 0 0 0 0 0
0 0 0 0 0 0 0 0 7 7 6 6 6 6  6  6 6 6 6 6 7 7 0 0 0 0 0 0 0 0
0 0 0 0 0 0 0 0 7 7 6 6 0 0  6  6 0 0 6 6 7 7 0 0 0 0 0 0 0 0
0 0 0 0 0 0 0 0 7 7 6 6 0 0  6  6 0 0 6 6 7 7 0 0 0 0 0 0 0 0
0 0 0 0 0 0 0 0 0 0 6 6 6 6  6  6 6 6 6 6 0 0 0 0 0 0 0 0 0 0
0 0 0 0 0 0 0 0 0 0 8 8 6 6  6  6 6 6 8 8 0 0 0 0 0 0 0 0 0 0
0 0 0 0 0 0 0 0 0 0 8 8 0 0  0  0 0 0 8 8 0 0 0 0 0 0 0 0 0 0
0 0 0 0 0 0 0 0 0 0 0 0 6 6  6  6 6 6 0 0 0 0 0 0 0 0 0 0 0 0
0 0 0 0 0 0 0 0 0 0 9 9 9 9 10 10 9 9 9 9 0 0 0 0 0 0 0 0 0 0
0 0 0 0 0 0 0 0 0 0 9 9 9 9 10 10 9 9 9 9 0 0 0 0 0 0 0 0 0 0
0 0 0 0 0 0 0 0 0 0 0 0 0 0  0  0 0 0 0 0 0 0 0 0 0 0 0 0 0 0