0 0 0 0 0 0  0  0  0  0  0  0  0  0  0  0  0  0  0  0  0  0  0  0 0 0 0 0 0 0
0 0 0 0 0 0  0 12 12 12  0  0  0  0  0  0  0  0  0  0 12 12 12  0 0 0 0 0 0 0
0 0 0 0 0 0 12 11 11 11 12  0  0  0  0  0  0  0  0 12 11 11 11 12 0 0 0 0 0 0
0 0 0 0 0 0 12 12 12 11 11 12 12 12 12 12 12 12 12 11 11 12 12 12 0 0 0 0 0 0
0 0 0 0 0 0 12  6  6 12 11 12 11 11 11 11 11 11 12 11 12  6  6 12 0 0 0 0 0 0
0 0 0 0 0 0  0 12  6  6 11 11 11 11 11 11 11 11 11 11  6  6 12  0 0 0 0 0 0 0
0 0 0 0 0 0  0  0 12 11 11 11 11 11 11 11 11 11 11 11 11 12  0  0 0 0 0 0 0 0
0 0 0 0 0 0  0  0 12 11 11 11 11 11 11 11 11 11 11 11 11 12  0  0 0 0 0 0 0 0
0 0 0 0 0 0  0 12 11 11 11 12 11 11 11 11 11 11 12 11 11 11 12  0 0 0 0 0 0 0
0 0 0 0 0 0  0 12 11 11 11 11 11 11 11 11 11 11 11 11 11 11 12  0 0 0 0 0 0 0
0 0 0 0 0 0  0  0 12 12 11 11 11  6 12 12  6 11 11 11 12 12  0  0 0 0 0 0 0 0
0 0 0 0 0 0  0  0  0  0 12 12 12  6  6  6  6 12 12 12  0  0  0  0 0 0 0 0 0 0
0 0 0 0 0 0  0  0  0  0  0  0  0 12 12 12 12  0  0  0  0  0  0  0 0 0 0 0 0 0
0 0 0 0 0 0  0  0  0  0  0  0  0  0  0  0  0  0  0  0  0  0  0  0 0 0 0 0 0 0